10
WWWWWWWWFWg
WEEEEEEEEW
WEEEWWWWWW
WWEEEEEEEW
WWWWWEEEEW
WEEEEWEEEW
WEEEEEEEEW
WEEEEEEEEW
WEEEEEEEWW
WWWWWWWWWW
1 2
