5
WWWFW
WEWEW
WEEEW
WWEEW
WWWWW
1 3
